NO ./.xpm/no_redbrick.xpm
SO ./.xpm/so_redbrick.xpm
EA ./.xpm/ea_redbrick.xpm
WE ./.xpm/we_redbrick.xpm
C 255,200,160
F 122,122,122

                                
                                
             11111111111111111
             1000000000000000111111111
             1000000000000000000000001
             1000000000000000111111111
             10000000000000001
             10000000000000001
             10000000E00000001
             10000000000000001
             10000000000000001
             10000000000000001
             10000000000000001
             10000000000000001
             11111111011111111
             11111111011111111
             11111111011111111
             11111111011111111
             11111111111111111
48127 87991 -23318 70911 23170 94792 85843 -25496 148371 96235 183892 57086 174684 180755 82610 5931 174444 126583 140743 21807 101648 196 36339 42265 81548 -16011 61745 130208 -20587 -7755 118284 21995 39225 193082 156060 -4658 118831 5198 136930 26908 34193 -3015 26497 126595 168276 164607 176566 30832 7670 116354 28475 192256 84597 65370 76153 143680 106515 -2680 72126 109770 178741 148775 16888 167210 144886 103169 39421 75120 31470 170214 29723 186880 138517 157974 78727 75576 8123 52900 107147 146393 26007 164226 -4663 -16269 146360 169014 174857 20238 137770 138780 3034 96590 110133 65769 174994 -13592 -21238 147271 163546 54122 127328 119152 101589 62370 115812 176296 153132 -14987 65248 105239 156551 31156 1789 144258 174035 92064 50867 60858 197355 175124 168227 -14506 112703 175003 64000 -11317 -1260 101165 101246 -8594 171829 120754 147323 52298 80617 85942 134713 90634 53639 13826 93367 183206 194054 113617 91860 14962 180995 180874 18285 120425 -10512 35293 33130 39656 -21884 54638 55652 140709 191703 40474 103984 7991 13109 104971 41971 14580 187344 115462 129780 60937 23341 63984 87048 152793 72516 84314 179302 174130 171148 -13818 -22524 82677 -26530 141025 128446 2996 128131 48961 166798 17069 28916 56215 22052 52432 22186 66134 4492 179391 131178 121639 131752 -1288 180067 72547 25074 139714 164223 -1918 26112 73351 -21837 69560 46797 56371 83789 181327 163057 137184 130193 172222 61545 123975 148875 -26192 15327 6404 132697 61041 130475 55854 110853 -25887 151967 175044 143046 -21667 150559 -26670 109573 157936 125799 89170 84691 3554 49034 156452 168628 56044 105133 32700 95356 -26482 71708 -1321 103594 35891 124921 179875 1106 94051 127608 11935 17254 148969 167910 160220 65049 176431 194323 176340 45016 61233 16884 23901 128779 26726 190537 152803 89443 126411 12696 70362 -26907 103607 -21350 -16731 -8042 88490 142601 108723 104377 138657 79799 195722 31838 45168 89021 162610 90364 123679 179294 -22776 25510 -14451 129977 34302 78423 82001 113943 31803 82579 173253 90895 142182 158434 143277 122145 6793 178932 24147 109419 60301 -21278 14594 121978 21509 77360 9173 98779 85495 38440 70990 58116 -19644 56366 127906 69530 -9091 42800 18226 146245 60078 -13094 27204 29192 77828 73341 166393 174639 91273 29582 25686 44407 162511 133072 17147 114590 12980 107708 182128 191252 43252 35235 124294 16721 63791 162989 38623 106511 24159 132352 95110 30394 156829 191965 135608 27363 12875 85274 83884 27242 197289 197837 126192 181867 170591 2828 158698 131140 6740 146077 27503 155650 8941 53591 96297 -12120 86769 157142 94506 75572 149408 150555 22910 175879 92283 -17017 39610 195933 179625 79406 149958 116156 52860 -2969 68648 7471 21776 123 117630 39813 7011 145808 119363 62289 163398 120764 166115 -18320 192964 174832 95014 -23891 182973 -14435 135821 58768 -21682 124077 103154 115405 190783 108580 102676 93302 100455 16639 128273 50827 153889 96412 164793 153101 28429 97592 115253 41901 22776 41753 195453 175645 147694 180269 42045 -5239 188703 -5751 27543 144315 106886 -15217 95147 -11104 25922 96007 140173 34826 -16557 39070 17959 63660 -3093 113144 51725 127007 112251 86476 70017 101580 55430 71255 142533 132139 36776 21991 3314 32488 198067 191389 -12610