NO ./maps/textures/wall_no.xpm
SO ./maps/textures/wall_so.xpm
EA ./maps/textures/wall_ea.xpm
WE ./maps/textures/wall_we.xpm
C 255,200,160
F 122,122,122

1111111111111111111111111111111111111111
1000000000000000000000000000000000000001
1000003000000000000000000000000000000001
1000000000100000000000000010000000000001
1000000000100000000000000010000000400001
1000000000000000000000000000000000000001
1000000000100000000000000010000000000001
10000000000000000N0000000010000000000001
1000030000100000000000000000000000000001
1000000000000000000000000010000000000001
1000000000100000000000000010000000400001
1000000000000000000000000000000000000001
1000000000100000002000000010000000000001
1000000000000000000000000000000000000001
1000000000020000000000000000000000000001
1000000000000000000000000000000000000001
1111111111111111111111111111111111111111


