EA ./maps/textures/wall_ea.xpm
WE ./maps/textures/wall_we.xpm
SO ./maps/textures/wall_so.xpm
NO ./maps/textures/wall_no.xpm



                
F 220,100,0
C 225,30,0

                                         11111
                                        11000111111111
11111111111111111                       11000000000001
100000000000000011111111111111111111111111000000000001
100000000000000000000000000000000000000000000000000001
100000000000000011111111111111111111111111111111111111
10000000000000001
10000000000000001
10000000N00000001
10000000000000001
10000000000000001
10000000000000001
10000000000000001
10000000000000001
11111011111111111
    101
11111011111111111
10000000000000001
10000000000000001
10000000000000001
10000000000000001
10000000000000001
10000000000000001
10000000000000001
10000000000000001
10000000000000001
10000000000000001
10000000000000001
11111111111111111