NO ./assets/textures/red_block.xpm
SO ./assets/textures/purple_block.xpm
EA ./assets/textures/brick_block.xpm
WE ./assets/textures/blue_block.xpm
C 255,200,160
F 122,122,122



  111111
  100001                                              1111111111111
  102200111111111                                      1000000000001
  106600000000011111111                  11111111111111000000000001
  10002200000000100000111111111111   1111110000000000000000000000001
  10000000000001000000000000000011111100010000000000000000000000001111
1111000000220000000000000000000000000002200010000000000000000000000001111
1000000000000001000000300000022000000000000000600000000030000000000011
1000000000000001000000000000000000000000010000000000000000000000000001
11000005000000011111111111111011111111111100000111111111111000050002011
1100000000000011            101          102000001        11100000000011
111100111000111  1111111111110111 111111 100000111        1000000011111
1111001111111    1000000000000001110000111000001          1000000011
1100000000111111110000000000000000000000000000001          100000001
11003000000000000000011111111100000111111111111111111111111000000011
1100000000000000000001       1000001         1000000000000000000001111
1111111000001111111111       1000001         1000000000000000000000001
     11111011111           111000001         100000000000000000W000001
   11100000000011          100022001         1000600111000000000000001
   100000000000011       1110000000111111111110006001110000300000000001
   100000000200001        11102200000000000000000000000010000050000111
   100000000000001       110000011111110000000100001110000010000000001
   100000000000001        1111011     10000000000001 11111111111111111
  1100000000000111           1011     10000030000001
  1000000000000111111111     101      10000000000001
 11000000000000000000001     1011    110000000000001
 110000000000000000000011111110011111100000011111111
1100000000000050000000000000000000000000000000000111
1000000000000000000000000000000000000000000000000011
1000000000000000000000000000000000000000000000000001
1000000004004000000000030300004000000000000000000001
1111111111111111111111111111111111111111111111111111


