NO ./assets/textures/red_block.xpm
SO ./assets/textures/purple_block.xpm
EA ./assets/textures/brick_block.xpm
WE ./assets/textures/blue_block.xpm
C 255,200,160
F 122,122,122

1111111111111111111111111111111111111111
1000000000000000000000000000000000000001
1000000000000000000000000000000000000001
1000000000100000000000000010000000000001
1000000000100000000000000010000000000001
1000000000000000000000000000000000000001
1000000000100000000000000010000000000001
10000000000000000E0000000010000000000001
1000000000100000000000000000000000000001
1000000000000000000000000010000000000001
1000000000100000000000000010000000000001
1000000000000000000000000000000000000001
1000000000100000000000000010000000000001
1000000000000000000000000000000000000001
1000000000000000000000000000000000000001
1000000000000000000000000000000000000001
1111111111111111111111111111111111111111


